{8,10}
(x)(x)(x)(x)(x)(x)(x)(x)
(x)(w)(x)(x)(x)(x)(x)(x)
(x)(x)(x)(x)(x)(x)(x)(w)
(x)(x)(x)(x)(x)(x)(x)(w)
(x)(x)(x)(x)(x)(x)(x)(x)
(x)(x)(x)(x)(x)(x)(x)(x)
(x)(x)(x)(x)(x)(x)(x)(x)
(x)(x)(x)(x)(x)(x)(x)(x)
(x)(x)(x)(x)(x)(x)(x)(x)
(x)(x)(x)(x)(x)(x)(x)(x)
Hero{0,0}