{8,10}
(w)(w)(w)(w)(w)(w)(w)(w)
(w)(x)(t)(w)(x)(x)(x)(w)
(w)(c)(w)(w)(x)(x)(x)(w)
(w)(x)(w)(x)(x)(x)(x)(w)
(w)(x)(x)(x)(x)(x)(x)(w)
(w)(x)(x)(x)(c)(t)(x)(w)
(w)(x)(x)(x)(x)(x)(x)(w)
(w)(x)(x)(x)(x)(w)(w)(w)
(w)(x)(x)(x)(x)(w)(x)(w)
(w)(w)(w)(w)(w)(w)(w)(w)
2
Hero{1,1}
Zombie{5,2}